# # # # # # # # # # # # # # # # # # # #
# # # # # # # # # # # # # # . # # # # #
# # # # # # # # # # # # # . . # # # # #
# # # # # # # # # # # # # . . . . # # #
# . # # # # . . . . . . . . . . . . # #
# . . . . . . . . . . . . . . . . . # #
# . . . . . . . . . . . . . . . . . . #
# . . . . . . . . . . . . . . . . . . #
# . . . . . . . . . . . . . . . . . . #
# . . . . . . . . . . . . . . . . . . #
# . . . . . . . . . . . . . . . . . . #
# . . . . . . . . . . . . . . . . . . #
# . . . . . . . . . . . # . . . . . . #
# . . . . . . . . . . . . . . . . . . #
# . . . . . . # . . . . . . . . . . . #
# . . . . . . . . . . . . . . . . . . #
# . . . . . . . . . . . . . . . . . # #
# . . . . . . . . . . . . . . . . # # #
# . . . . . . . . . . . . . . . . . # #
# # # # # # # # # # # # # # # # # # # #
