# # # # # # # # # # # #
# # . . # # # # # # # #
# # . . # # # # # # # #
# . . . # # # # # # # #
# . . . . # # # # # # #
# . . . . # . # # # # #
# . . . # # . . # # . #
# . . . . . . . . . . #
# # . . . # . . # . . #
# # . . # . . . . . . #
# # . . . . . . . # . #
# # # # # # # # # # # #
