# # # # # # # # # # # # # # # # # # # #
# . . . # . . # . . . . . . . . . . . #
# . . . . . . . . . . . . . . . . . # #
# . . . . . . . . . . . . . . . . . . #
# . . . # . . . . . . . # . # . . . . #
# . . # # # . # . . . . . . . . . . . #
# . . . # # # # . . . . . . . . . . . #
# . # # # # # # . . . . . . . . . . . #
# . . . # # # # . . . . . . . . # . . #
# . . . # # # # . . . . . . . # . . . #
# . . . # # # # . . . . # . . # . . . #
# . . . . # # # . . . . . . . . . . . #
# . . . . . # . # # . # . . . . . . . #
# . . # . . . . # . . # . . . . . . . #
# . . . . . . . . . . . . . . . . . . #
# . # # # . . . . . . # . # . . # . . #
# . . # . . . . . . # # # . . . # # . #
# . . # # . . . # # # # # # . . # # # #
# # # # # # . # # # # # # # # # # # # #
# # # # # # # # # # # # # # # # # # # #
