# # # # # # # # # # # # # # # # # # # #
# # # # # # . . . # # # # # # # # # # #
# # # # . . . . . . # # # # # # # # # #
# # # . . . . . . # # # # # # # # # # #
# # # # . # . . . . . # # # # # # # # #
# # # # # # . . . . # # # # # # # # # #
# # # # # . . . . . . # # # # # # # # #
# # . . . . . . . . . . # . . # # # . #
# . . . # . . . . . . . . . . . . . . #
# . . . . . . . # . . . . . . # . . . #
# . . . . . . . . . . . . . . . . . . #
# . . . . . . . . . . . . . . . . . . #
# . . . # . . . . . . . . . . . . . . #
# . . . . . . # . . . . . . . . . . . #
# . . . . . . . . . . . . . . . # . . #
# . . . . . . . . . . . . . . . . . # #
# . . . . . . . . . . . . # . . . # # #
# # . . . . . . # . . . . # . . . # # #
# # # . . # # # # . . # # # # # # # # #
# # # # # # # # # # # # # # # # # # # #
