# # # # # # # # # # # # # # # # # # # #
# # . . . . . . . . . . . # # # # # # #
# # . . . . . # . . . . . . # # # # # #
# # . . . . # # # . . . . . . # # # # #
# # . . . # # # . . . . . . # # # # # #
# # . . . . # # . . # . . # . . # # # #
# # # . . # # . . . . . . . . . # # # #
# . . . . . # . . . . . . . . # # # # #
# # . . . # # . . . . . . . . . # # # #
# # . . . . . . . . . . . . . # # # # #
# # . . . . . . . . # . . # # # # # # #
# # # . . . . # . # . . . . # # # # # #
# # # # # # # # . # . . . . . # # # # #
# # # # # # # # . # . # . . . # # # # #
# # # # # # # # . # . # . . . . # # # #
# # # # # # . . . . . . . . . . . . # #
# # # # # # # . . . . . . . . . . . . #
# # # # # # # # # . . . # . # # # . # #
# # # # # # # # # # # # # # # # # # # #
# # # # # # # # # # # # # # # # # # # #
