# # # # # # # # # # # # # # # # # # # #
# # . . . . . . . . . . . . . . . . . #
# . . . . . . . . . . . . . . . . . . #
# . . . . . . . . . . . . . . . . . . #
# # . . . . . . . . . . . . . . . . . #
# . . . . . . . . . . . . . . . . . . #
# . . . . . . . . . . . . . . # . . . #
# . . . . . . . . . . . . . . . . . . #
# # # . . . . . . . . . . . . # # . # #
# # . . . . . . . . . . . . . . . # # #
# . . . . . . . . . . . . . . . . . # #
# . . . . . . . . . . . . . . . # # # #
# # . . . # . . . . . . . # # . # # # #
# # # # . # # . . . . . . # # # # # # #
# # # # # # # . # . . . . # # # # # # #
# # # # # # # # # # # # # # # # # # # #
# # # # # # # # # # # # # # # # # # # #
# # # # # # # # # # # # # # # # # # # #
# # # # # # # # # # # # # # # # # # # #
# # # # # # # # # # # # # # # # # # # #
