# # # # # # # # # # # # # # # # # # # #
# # # # # # # # # # # # # # # # # # # #
# # # # # # # # # # # # # # # # # # # #
# # # . . . # . # # . . # . # # # # # #
# # . . . . # . . # . . . . . . . # . #
# . . . . . # . . . . . . . . . . . . #
# . . . . . . . . . . . . . . . . . . #
# . . . . . . . . # . . . . . . . . . #
# . # . . . . . . . . . . . . . . . . #
# . . . . . . # # . . . . . # . . . . #
# . . . . . . # # . . . . . . . . . . #
# # . . . . # # . . . . . . . # . . . #
# . . . . . . # . . . . . # . . . . . #
# . . . . . # . . # . . . . . . . . . #
# # . . . . . . # . . . . . . . . . . #
# # . . . . . # # . . . . . . . . . . #
# # . . . . # # # # . # . . . . # . . #
# # # . . . # # # # # # . . . # # . . #
# # # . . # # # # # # # # # # # # # # #
# # # # # # # # # # # # # # # # # # # #
