# # # # # # # # # # # # # # # # # # # #
# # # # # # # # # # . . . . . . . . . #
# # # # . . # # # # # . . . . . . # # #
# # # # . . # # # # # # . . . . . # # #
# # # . # . . # # # # # . . . . . . # #
# # . . . . . . . # # # . . . . . # # #
# # # . . . . . . . # # . . . . . # # #
# # . . . . . . . . . # # . . . . . # #
# # # . . . . . . . . # # . . . . . # #
# # . . . . . . . . . . . # . . . . . #
# # # # . . . . . . . . . . . . . . . #
# # # # . # . . . . . . . . . . . . . #
# # # # # . . # . # # . . . . . . . . #
# # # # # # . # . . . . . . . . . . . #
# # # # # # # # # # # . . . . . . . . #
# # # # # # # # # # # # # . # # . . # #
# # # # # # # # # # # # # # # # # # # #
# # # # # # # # # # # # # # # # # # # #
# # # # # # # # # # # # # # # # # # # #
# # # # # # # # # # # # # # # # # # # #
