# # # # # # # # # # # # # # # # # # # #
# # # # . # # # # # . # # # # # # # # #
# . . # . . . # # # . # # . # # # # # #
# . . . . # . # . # . . . . # # # # # #
# . . . . . . . . . . . . . . . # # # #
# . . . . # # . . . . . . . # # . # # #
# . . . . # . # . . . # . . # # . . # #
# . . . . # . . . . . . . # . # . . . #
# . # # # . . . . . . . . . . . . . . #
# . . . # . . . # . . . . . . . . . . #
# . . . . . . # # . . . # . . . # # # #
# . . # . . . # # # # # # # . . # # # #
# . . # . # . # # # # # # # . # # # # #
# . . . # . . . # # # # # # # # # # # #
# . . . . . . . # # # # # # # # # # # #
# . # . # . # # # # # # # # # # # # # #
# # # # # # # # # # # # # # # # # # # #
# # # # # # # # # # # # # # # # # # # #
# # # # # # # # # # # # # # # # # # # #
# # # # # # # # # # # # # # # # # # # #
