# # # # # # # # # # # # # # # # # # # #
# # # # # # . . . . . . # # # # # # # #
# # # # # # . . . . . . . # # # # # # #
# # . . # . . . . . . . . # # # # # # #
# . . . . . . . . . . . . . . # # # # #
# . . . . # . . . . . . . . . # . # # #
# . . . . . . . . . . . . . . . . . # #
# . . . . . . . . . . . . . . . . . # #
# . . . . . . . . . . . . . . . . . # #
# . . . . . . . . . . . . . . . . . # #
# . . . . . . . . . . . . . . . # . # #
# . . . . . . . . . . . # . . # . . . #
# . . . . . . . . . . . . . . . . . . #
# . . . . . . . . . . . . . . . . . . #
# . . . . . . . . . . . . . . . . . . #
# . . . . . . . . . . . . . . . . . . #
# . . . . . . . . . . . . . . . . . . #
# . . . . . . . . . . . . # . . . . . #
# . . . . . . . . # # # . # . . . . # #
# # # # # # # # # # # # # # # # # # # #
