# # # # # # # # # # # # # # # # # # # #
# # # . # # . # . . . . # # . # . # # #
# . . . . . . . . . . . # . . . . . . #
# . . . . . . . . . . . . . . . . . . #
# . . . . . . . . . . . . . . . . . . #
# . . . . . . . . . . . . . . . . . . #
# . . . . . . . . . . . . . . . . . . #
# . . . . . . . . . . . # # . . . . . #
# . . . . # # . . . . . . # . . . . . #
# . . . . . . . . . . . . . . . . . . #
# . . . . . . . . . . . . . . . . . . #
# . . . . . . . . . . . . . . . . . . #
# . . . . . . . . . . . . . . . . . . #
# . . . . . . . . . . . . . . . . . . #
# . . . . . . . . . . . . . . . . . . #
# # . . . . . . . . . . . . . . . . . #
# # # . . . . . . . . . . . . . . . . #
# # # . . . . . . . . . . . . . . . . #
# # # # . . . . . . . . . . . . . . . #
# # # # # # # # # # # # # # # # # # # #
