f f f f f w f f f w f f f f w f f f w f f f f f w f f f f f w w f f f f f w f f f f w f f f f f f f f f f w w f f w w f f f w w f w f f f f f w f w w f f f w w f f f f f f f f f w f f f w w f f f f f 
f w w w f w f w f f f w w f f f w f w f w w w f w w f w w w w f f w w w f w w f w f f f w w w w w w w w f f w w f f f f w f f f f w w w f w f w f w f f w f f w w w f w w w w w f f f w f f f f w w w f 
f w f w f w f w w w w w f f w f w f w f f f w f w f f f w w f s w w f w f f f f w w w w w f w f f f f w w f f w w w f w w w w w f w w f f w f w f f f w w w f f w w f w f f f w w f w w w w w w w w f f 
f f f w f w f f f w w f f w w f w f w w f w w f w w w f f w f w w f f w w w w w w f w w f f w f w w f w w w f w f f f w f f f w f f w f w w f w w f w w w w w f w f f f f w w w f f w f f f f f w f f w 
w w w w f w w w f w f f w w w w w f w w f w w f w f w w f f f w f f w w f f f f w f f w w f w f w f f f w f f w f w f w f w f w w f f f w f f f w f f w w f w f f f w w w w w f f w w f w w w f w f w w 
f f f f f w f w f w f w w w w w f f f w f w w f w f w w w w w w w f w w w f w f w w f f w f w f w f w w w f w w f w f w f w f f w w w w w w w f w w f f w f w f w f w w f f f f w w w f w f f f w f f w 
w f w w f w f w f w f w w w w f f w f f f w f f f f w f f f w w f f f f w f w f w w w f f f w f w f f w f f w w f w w w f w w f f f f f f f w f f w w f w f w w w w w f f w w w w w f f w f w w w w f f 
f f f w f f f w f w f w w w f f w w w w w w w w w f w w f w w f f w f w w f w f f f w w f w w f w w f f f w w f f f f w f w w w w w w w f w w w f w w f f f f w f w f f w w f f f w f w w f f f f w w f 
f w w w f w w w f w f f w f f w w w w f f f w w f f w w f f f f w w f f w f w f w f f f f w f f f w w w w w w w w f w w f w f f w w w w f w f w f f w w w w w w f f f w w f f w f w f w w w f w w w w f 
f f f w w w w f f w w f w w w w f w f f w f f w f w w f f w w w w w w f f f w w w w w w f w w w f f w f f f w w f f w w f w w f f w w w f w f w w f f f w f f f f w w w f f w w f w f f f w f f f f w f 
f w f f w f f f w w w f f f w f f f f w w w f w f f f f w w w f f f w w w w w w f f f w f w f w w f w w f w w f f w w f f f w w f f w w f f f f w w w f w f w w w w f w f w w w f w w w f w w w w f w f 
f w w f f f w f w f w w w f w w w f w w w f f w w w w w w f f f w w w f f f f f f w f w f f f f w f f w f f f f w w f f w f w w w f f w w w w f f f w f f f w f f f f w f f w w f f w f f f f w w f w f 
f f w w w w w w w f f f w f f w w f w f w f w w f f f f f f w f w w f f w w w f w w f w w w w f w w f f f w w w w w f w w f w w w w f f f w w w w f w w w w w w f w f w w f f w w w w f w w w w f f w f 
w f w f f f f w f f w f w w f w f f w f f f f f f w w w w w w w w f f w w w f f w f f f f w w f f w w w w w f f f w w w w f f w f w f w f f f f w f w w f f f w f w f f w w f f w f f f w f f f f w w f 
f f w f w w f w w w w f f w f w f w w f w w w w w w f f f w w w f f w w f f f w w w w w f f w w f f f f f f f w f f f f w w f w f w f w w f w w w f f f f w f f f w w f f w w f w f w w w f w w f f w f 
f w w f w f f f w f f f w w f w f w w w w f f f f w f w f f w f f w w f f w w w f f f w w f f w w w w w w w w w w w w f f f f w f w f f w f f w w w w w w w w w w w w w f f w f w f w f f f w w w f w f 
f w f f w w w f f f w w w f f w f f f w f f w w f f f w w f f f w w f f w w f w f w f w w w f f f f f f f f f w f w w w w w w w f w w f w w f f f f f f w f f f f f f w w f f f w f w f w w w f w f w f 
f f f w w w f f w w w w f f w w w f w w f w w w w w w w w w w w w f f w w w f w f w f f w w f w w w w f w w w w f f f w f f f f f f w f w w w w w w w f f f w w w w f w w w w f w f w f f w w f f f w f 
w w f w f w f w w w f f f w w w w f w f f f f f f w f f f w w f f f w w f w f f f w w f f w w w f f w f w f f f f w f f f w w f w w w f w f f f f f w w f w w f f w f w f w w f w f w w f f w w f w w f 
f w w w f w f w f f f w w w f w w f w w w w w w f w w w f w f f w w w w f w f w w w w w f f f f f w w f w f w w w w w w f f w f f w f f f f w f w w w f f w f f w w f f f w f f w f w w w f w w f w f f 
f f w w f f f w f w w w f f f w f f f f f f f w f f w f f w f w w f f w f w f f f f w w w w w w f w f f w f f f f f w w w f w w f w f w w w w f f w w f w w w f w w w w f w f w w f f f w f w f f w f w 
w f w f f w f w f f w w w f w w f w w w w w f w w f w f w w f w w w f f f w w w w f f f w f w f f w f w w w w w w f f f w f f w w w f f f w w f w w f f w f f f w w f f f w f f w w w f w f w w w w f w 
f f w f w w w w w f f f w f w w f f f f w w f w f f f f f w f w f w f w f f w w f f w f f f w f w w f f f w f f w w f w w w f f f w f w f f w w w f f w w f w f f w f w w w w f w f f f w f f w w f f f 
f w w f f w w f w w f w w f f w w w w f f w f w w w f w w w f w f w f w w f f w w w w w f w w f f w w w f f f w w f f f f w w f w w f w w f f w w f w w w w w w f f f f w f w f w w f w w w f w f f w w 
f f w w f f w f w w f f w w f f f f w f w w f w w f f w w f f w f w f f w w f f w w f f f f w w f f w w f w f w w w w w f f w f f w w w w w f f w f f f f w f w w f w f w f f f w f f w w f f w f w w f 
w f f w w f w f f w w f f w w f w f f f w f f w f f w w f f w w f w w f w w w f f w w f w f f w w f f w w w f w w f w w w f w w f f w w f w w f w w w w f f f w w f w w w f w w w f w w f f w w f w w f 
w w f f f f w w f f w w f f w f w w w w w f w w f w w f f w w f f w w f f f w w f f f f w w w w w w f f w w f f f f w f w f w w w f f f f w w f f w f w w f w w f f f w f f w f f f w f f w w f f f f f 
w w w w f w w f f w w w w f w w w f f f w f f f f w f f w w w w f f w w w f w w w w w w w w f f f w w f f w w w w f f f w f w f w w w w f f w w f f f f w f f w w w f w f w w f w w w f w w w w w w w f 
w w w f f f w f w w w f w f f w f f w f w w f w w w f w w w f w w f f f f f w f f w w f f w f w f f w w f f w f w w w f w f f f w w f w w f f w w w w f w w f f w f f w f f w f w f w f w f f f f f w f 
w w f f w w w f w w f f w w f f f w w f w f f f f w f w f f f w w w w w f w w w f f f f w w f w w f f w w f f f f w f f w w w f f f f f w w f f f w f f w w w f w w w w w f w f w f w f w w f w w w w f 
w f f w w f f f f w f w w w w w w w f f w w w w f w f f f w w w f f f w f f f w w w f w w w f w w w f w w w f w f w f w w f w f w w w f w w w f w w f w w f w f f f w w f f w f f f w f f f f f w w f f 
f f w w f f w w f f f f w w f f f w f w w f f f f w w f w w f f f w f w w w f w w f f f f w f f f w f f w f f w f w f f w f w w w f w f f f w f f w f f w f w f w f f f f w w w f w w w f w w f f w f w 
f w w f f w w w w w w f f w f w w w f w w w w w w w w f w w f w w w f f f w f f f f w w f w w w f w w f w f w w f w w f f f f w f f w w f w w w f w w f f f w w w w w w w w f w f f w w f w w w f w f f 
f w f f w w f f f w w w f f f w w f f w f f f f f w w f w w f f f w w w f w w w w w w w w w f f f f w f w f w w f w w w w w f w f w w f f f w w f f w w w f f f f w f f f f f w w f f w f f w w f w w f 
f w w f w f f w f w f f f w w w f f w w f w w f w w f f f w w w f w f w f f f f f w f f f w w f w f w f w f w f f f w w f f f f f w w w w f f w w f f f w w w w f w f w f w w w w w f w w f f w w w w f 
f w f f w f w w f w f w w w f f f w w f f f w f w f f w f f f f f f f w w f w f w w f w f f w f w w w f w f w w w f f w w w w w f f f f w w f f w w w f f w f f f w f w f f f f f w f f w w f f f f w f 
f f f w w f w w w w f w f f f w f f w f w w w f w f w w f w w w w w w w w f w f f w f w w f w f w f f f w f f f w w f f w w f w f w w f w w w f f f w w f f f w w w f w w f w w f w w f f w w w w f f f 
w w w w w f w f w f f w f w f w w f w f w f w f w w w w f w f w f f f f w f w w f f f f w f w f w w f w w f w f f w w f f w f w f w w w w f f f w f f w w f w w f f f f w f f w f f w w f f f w w w w w 
f f f f w f w f w f w w f w f w w w w f w f w f f f w f f w f f f w w f w w w w f w w w w f w f f w f w f f w w f f w w f f f w f w f w f f w f w w w w w f w w w f w w w w f w w f f w f w f f f f f f 
w f w f f f w f w f w f f w f f w w f f w f w w w f w w f w f w w w w f f f w f f f f w f f w w f w f w w w w w w f f w w w w w f w f w f w w w w f f f w f f w f f w f w w f f w w w w w w w w w w w f 
f f w w w f f f w f w f w w w w w f f w w f f f w f f w f w f w f f w w w f w w w f w w f w w w f w f f w f f f w w f f f f f w f f f w f f f w f f w f w w w w f w w f f w w f f f f f w w f f f f f f 
f w w f f f w w w f w f f f w w f f w w w w w f w w f w f w f w w f w f w f w f w f f w f w f w f w w f f f w f f w w f w f w w w w f w w w f w f w w f f f f w f f w w f w w w w f w f w f f w w w w w 
f w w f w w w f f f w w w f f f f w w w w w f f f w f w w w f f w f w f w f w f w w f w f w f w f f w w w w w w f f w w w f f f w w f f w w f w f f w w w f w w w f f w f w f w f f w f w f w w w w w f 
f f w f w w f f w w w f w w w w w w f f f f f w w w f f f w w f f f f f w f w f w f f w f f f w w f f w f f f w w f f w w f w f f w w f w f f w w f w f w f f w w w f f f w f f f w w f w f w f f f f f 
w f w f f w f w w f f f f w f f w w w w w w f f f w w f w w w w f w w w w f w f w f w w w w f w w w f f f w f f w w f f w w w w f w f f w f w w f f f f w w f f f w w w f w f w w w w f w f w f w w w f 
w f w w w w f w w f w w f f f w w f f f f w w f w w f f f f f w f w w f f f w f f f f f w f f f f w w w w w w f f w w f f f f w f w f w w f w w w w w f f w w w f w f f f w f w w f f f w f f f w f w f 
w f f f w w f f w f w w w w f f f f w f w w f f w w f w f w f w f w f f w w w w w w w f w f w f w w f f f f w w f f w w f w w w f w f w w f f w f f w w f f f w f w w f w w f f w f w w w w w w w f w f 
f f w f f w w f f f w f f w w w w w w f w f f w w f f w f w f w f w f w w w f f f w f f w f w f f f f w w f f w w f w w f f f w f w f f w w f f f w w w w w f w f w w f w w w f w f f f f f f w f f f f 
f w w w f f w w w w w f w w f f f w f f f f w w w f w w f w f w f w f f f w w f w w f w w f w w w w f f w w f f w f f w w f w w f w w f w w w w f f f w f f f w f f f f w f f f w w w w w f w w f w w w 
f w f w w f w f f f f f f f f w f w f w w w w w f f w f f w w w f w w w f w w f w f f f w f f f w w w w w w w f w w f w w f w w f w f f f f w w w w f w f w w w w w w w w f w f w f w f w f w f f w f w 
f f f w f f f f w w w w w w f w f w f w f f f f f w w f w w f f f w f w f f w f f f w f w w w f w f f f w w f f f w f w f f f w f w w w f w w f f f f w f w f f f w w f f f w f w f f f w f w f w w f f 
w w f w f w w f f w f f f w f w f w f w w w f w f w f f w f f w w w f w w f w w w w w f w f w f w f w f f w w w f w f w f w w w f w f w f w w f w w w w f w f w f f w w f w w w w f w f f f w f w w w f 
f w f w f f w w w w f w f w w w f w f w w f f w f w f w w f w w f f f f w f f f w w f f f f w f f f w w f f f w f w f w f f f w f w f w f w w f f f f w f w f w w f w f f w f w w f w w w w w f f f w f 
f w f w w f f f w f f w f f f w f w f f w f w w w w f w w f w w w f w f w w w f f w f w w f w w w w w w w f w w f w f w w w f w f f f w f f w w w w f w f f f w f f w f w w f f w f f f f f w w f w w f 
f f f f w w f w w f w w w w f w w w w f w f w f w w f f w f f f w f w f f f w w f w f w w f w w f f f w w f f w w w f w f f f w w f w w w f f f f w f w w w w w f w w f w w w f w w w w w f w w f w f f 
w w w f f w f f w f f f w w f f f f f f w f w f f w w f w w w f f f w w w f w f f w f w f f f w w w f f w w f f w w f w f w w w w f w f w w w w f w f w f f f w f w w f w f f f f f f f w f w f f w f w 
w f w w f w w f f f w f f w w w w w w w w f w w f f f f f f w w w w w w f f w f w w f w w w f f f w w f f w w f f f f w f f f w f f f f w f w w f w f f f w f w f w w f w w f w w f w f w f w f w w f w 
f f w w f w w w w w w w f f w f f f f w f f w f f w w w w f f w w f f f f w w f f w f w w f f w f f w f w w w w w f w w f w f w f w w f f f w f f w w w w w f w f f w f f w w w w f w f f f w f w w f w 
f w w f f w f f f f f w w w w f w w f w f w w w w w f f w w f f w w w f w w w w f w f f w w w w w f f f w f f f w w w f f w f w w w w w w f f f w w f w f w f w w f w w f f f f w f w w w w w f f w f f 
f w f f w w w w w w f w f f f f f w f f f w f f f w w f f w w f f w w f w f f w f w w w w f f f w w w f w f w f f w w f w w f f f f f f w w w f w f f w f f f f w f w w w f w w w f w f f f w w f w w f 
f w f w w f f f w w f w f w w w w w f w w w f w f f w w f f f f w w f f w w f w f f f w w f w f f w w w w f w w f f w f f w w w w w w f f w w f f f w w f w w w w f w w f f f f w f w w w f w f f f w f 
f w f w w f w f f w f w f f f w f f f f w f f w w f w w w w f w w f f w w w f w w w f w f f w w f f f w w f f w w f w w f w w f f f w w f f w w w f w w f f f f w f f w w w f w w f f w w f w w w f w f 
f f f f w f w w f f f w f w f w f w w f w f w w f f f f w w f w f f w w f w f w f w f f f w w w w w f f w w f f w f w f f w f f w f f w w f w w f f f w w w f w w w f w f w f f w w f f w f w f w f f f 
w w w f f f w f f w f w w w f w f f w f w f f w w w w f f w f w f w w w f f f f f w f w w w f f f w w f w w w f w f w w f w f w w w f f w f f w w w f w f w f w w w f f f w w f w w w f f f f f w w w f 
w f w w w w w f w w w w f f f w w f w f w w f f f w w w f w w w f f f w w f w w f w w w f f f w f w f f f f w f w f f w f w f w w w w f w w f w w f f w f f f f w f f w f f w f f w w f w w w f f w w f 
f f f w f f w f w w f f f w w w w f w f w w w w f w f w f f w w w w f w f f w f f w w f f w w w f w f w w f w f w w f w w w f f w w f f w f f f w w w w f w w w w f w w w f w w f w f f f f w w f f w f 
f w f f f w w f f w f w w w f f w w w f w w f w f f f w w f f f f w f f f w w f w w f f w w f w f w f w w w w f w w f w f f f w w f f w w f w f f f f w f f f w f f f w w w w f f w w w w f f w w f w f 
f w w w f w w w f w f f w w w f f w f f f f f w w w f f w w f w w w w w w w w f f f f w w w f f f w f f f w w f e w f f f w w w f f w w f f w w w w f w f w f w f w f w f f f f w w f f w w f w w w w f 
f f f w f w w f f w w f f w w w f f f w w w f f f w w f f w f f w w f f f f w w w w w w f w f w w w w w f f w w f w w w w w w f f w w w f w w f w w f w f w w w f w w w f w w w w w w f w w f w f w f f 
f w f w w w f f w w w w f w f f f w w w w w w w f w w w f w w f f f f w w f f w f f f f f w f f f f f w w f f w f w f w f w f f w w f w f f w f w f f w f w f f f w f f f w f f f f w f w f f f f w f w 
f w f f f w f w w f f w f w f w f w f f f f w w w w f f f f w f w f w w w w f w w f w w f w w w w w f w w w f f f w f f f w f w w f f w w f f f w f w w f w f w w w f w w w w f w w w f w f w w f w f f 
f w w f w w f f w f w w f w w w w w f w w f f f w f f w w w w w w f w f f w f f f f w f f w f f f w f f f w w w w w w f w w f w w w f f w w w f w f f f f w f f f w f f w f w f f f f f w f f w w w w f 
f f w f f w w f f f f w f f f f w f f w w w f w w f w w f w f f f f w f w w w w w w w f w w f w f w w w f f w f f f f f w f f w f w w f f w w f w w w w w w w w f w w f f f w w w w f w w w f f w w w f 
w f w w f w w w w w f w w f w f w f w w f w f w w f w f f f f w w w w f w f f f f w f f f w f w f f f w w f f f w w w w w f w w f f w w f w f f w f f f w f f w f f w w w f f f f w f f w w w f f w f f 
f f f w f f f f f w f f w f w f w f w w f w f w w f w w w f w w f f f f f f w w f f f w f w f w w w f w w w w f f w w f f f w w w f f f f w f w w f w f f f w w w f w f w w w w f w w f f f w w f w f w 
f w w w w f w w w w w f w f w w w f f f f w f f w f f w w f f w w w w w f w w w w w w w f w f f f w f f w f w w f f w w f w w f w f w f w w f f f f w f w f w w f f w f f f f w f f w w w f f w f w f w 
f f f f w f f f w f f f w f w w f f w w f w w f w w f f w w f w f f f w f w w f f f w f f w w w f w w f f f w w f w w f f w f f w f w f f w f w w w w f w w w f f w w f w w f w w f f w w w f w f w f f 
w w w f w w w f f f w f w f w f f w w w w w f f f w w f w w f w f w f w f w f f w f w w w w f w f f w w w f w w f w f f w w f w w f w w f f f f w w f f f w f f w w w f w w f f w w f f w w f f f w w f 
f f w f f f w w w w w w w f f f w w w w f f f w f w w f f w f f f w f w w w f w w f w w f f f w w f f f w f w w f w f w w f f w w f f w w w w w w f f w w w f w w f f f f w w f w w w f f w w w w w f f 
f w w w w f f f f f f w w w w w w f f f f w w w f f w w f w w w w w f f f w f w f f w f f w f f w w w f w f f f f w f w w w f f w w f w f f f f w f w w w f f w f f w w f f w f f w w w f f w w f f f w 
f f f f w w w w w w f f f f f f w w w f w w f w w f f w f f f f f w w f w w f w f w w f w w w f f w f f w w w w w w f f f w w f f f f w f w w f w f f f w f w w w f f w w f w w f w f w w f f w f w w w 
f w f w w w f f f w w w w w w f w f f f w w f w w w f w w w w w f f w f f f f w f w w f f f w w f f f w w f f f w w w w f w f f w f w w f f w f w w w w w f f f w w f w f f w f f f f w w w f f f w f f 
f w f w f w f w f f f w w w f f w f w w w f f w f f f w f f w w w f w w w w w w f f w w w f f w w w w w f f w f w f f w f w f w w f w w w f w f f f f w w w w f w f f w f w w w w w f f w w w w w w f w 
w w f w f w f w f w f f w f f w w f w f f f w w f w w w w f f f w f w f f f f w w f f f w w f f f f w w f w w f f f w w f w w w w f w f w f w w w w f f f w w f w w w w f w f f f w w f f f w f f f f f 
f f f f f w f w w w w f f f w w f f w w f w w w f f f f w w w f w f f f w w f f w w w f w w w w w f f f f w f f w f f w f f w w f f f f w f f w w w w w f f w f w w f f f w f w w w w w w f f f w w w f 
f w w w f w f f f f w w w w w f f w w f f w f w w w w f f w f f w w w w w w w f w f f f f f f w w w w w w w w w w w f w w f f w w w w f w w f f w f f w w f w f w f f w w w f w f f f w w w w w w f f f 
f w w w w w w w w f w f f f w f w w f f w w f f f f w w f w f w w f w f f f w f w f w w w w f w f f f f f f w w f w f w w w f f f w w f f w w f f f w w w f w f f f w w f f f w f w f f f w w f w w f w 
f w w w f f f w w f w w f w w f f w w f f f f w w f w w f f f f w f w f w f f f w f f f f w f w f w w w w f f w f w f f f w w w f f w w w w w w w f f f w f w w w w w w w f w w f w w w f w f f w f f f 
f w w f f w f f w f f w f w w w f f w w w f w w f f f w w w w f f f w f w w w w w w f w w w f w f w f f w w f f f w w w f f f w w f f f w w f f w f w f w f w f f f f w f f f w f w f w f f f w w f w w 
f f w f w w w f w w f f f f w w w f f w f f f w w w f w f f w w w f w f f f f w f w f f f w w w f f f w w w w w f f f w w w f w w w w f w f f w w w w f w f w f w w f f f w f w f f f w w f w w w f f f 
w f w f f f w f w w w w w f f f w w f w w w f f w w f w w f f w f f w w w w f f f w f w f f f w w w f w f f f w w w f f f w f f w f w f f f w w w w f f w f f f w w w w w w f w w w f f w f f f w f w f 
f f w w w f w f f f f f w w w f f w f f f w w f f w f f w w f w f w w f f w w w f w w w w w f w f f f w f w f w f w w f w w w f f f w w f w w f w f f w w w w f f f w w f f f f f w w f w w f w w w w f 
f w w f f f w f w w w f f f w w f w w w f f w w w w w f f w f w f f w w f f f w f f f f w f f w f w w w f w f w f w f f f f w w f w w f f f w f w f w w f f w w w f f w w w w w f f w f f w f w f w f f 
f w w w f w w w w f f f w f f w f f f w w f f f w f w w f f f w w f f f f w w w w w w f w f w w f f f w f w f f f w w w w f w f f f w f w f f f w f w w w f f f w w f f f w w w w f w w f w f f f w f w 
f w w w f f w w f f w w w w f w w w f f w w w f f f w w f w f w w f w w w w w f f f w f w f w w w w f f f w w w f w w f w f w w w f w f w w w f w f f w f f w f f w w w f f w w w f w w f w w f w w f f 
f w w w f w w f f w w f f f f f f w w f f f w w f w w f f w f f w f w f f f w f w f f f w f f f f w w w w w f w f f w f w f f f w f w f f f w w w w f f f w w w f f f w w f f w f f f w f w f f f w w f 
f w w w f w f f w w w w w w w w f f w f w f f w f f w w f w w f f f w f w f w f w w w w w w f w w w f f f w f w w f f f w w f w w f w w w f f w w w w w w w w w w w f f w w f w w w w w f w f w w w w f 
f f w w f w f w w w f f f w f w w w w w w w f w w f f w w w w w w w w f w f f f w f f f f w f f w f f w f f f f w w w f f w f f w f f f w w f f w f f f w f f f w w w f w w f f f w f f f w f f f f w f 
w f f w f w f f w f f w f f f w f f f w f f f f w w f f f w f f f w w f w w w w w w f w f w w f w f w w w w w f f w w w f w w f w w w f w w w f w f w f w f w f f f f f f w w w f w f w w w w w f w w f 
w w f f f w w f f f w w f w f f f w f f f w w f f w f w f f f w f f f f f f f f f f f w f f w f f f f f f f w w f f f f f f w f f f f f f f w f f f w f f f w f w w w w f f f w f f f f f f f w f f f f 
